马铃薯 利于 减脂	n v n
三峡 导游词 300字	ns n mq
耳朵 上火 疼 怎么办	n v v r
班级 愿景 寄语	n n v
每次 打开 office2007 excel 都 要 配置	r v ws ws d v v
如何 显著 提高 电脑 的 运行速度	r a v n u n
excel 在 调整 一页 打印 后 在 怎样 分页 打印	ws p v mq v nd p r v v
j&n tyre supplier co . , ltd	ws ws ws ws wp wp ws
香烟 爱上寂寞 日志	n n n
vip58 ganjin	ws n
天津 9 、 10月 气温	ns m wp nt n
哪 些 属于 关联方	r q v n
女 棒球 外套 怎么 搭配	b n n r v
怎么 能 找回 微信 聊天记录	r v v n n
小伙 恋 上 母驴 日以继夜 侵犯	n v nd n i v
天津 塘沽 客运 码	ns ns n v
吴琼 有 孩子 吗	nh v n u
开通 淘宝店 需要 什么 证件	v n v r n
瑞士 留学 一年 费用	ns v mq n
桐乡 朱 未	ns nh d
6plus 和 6splus 区别	ws c ws n
张秀勤 头部 刮痧 视频	nh n v n
苏州 哪 个 区 潜力 大	ns r q n n a
小卫士 图片	n n
青稞面 怎么 吃	n r v
浙江省 建造师 注册 网	ns n v n
团队 旅游 策划方案	n v n
地下城 黑暗 武士 的 副 武器 怎么 带	n a n u b n r v
股权 是否 可以 二次 质押	n v v mq v
2017年 世界 拳击 次重量级 ko 集锦	nt n n n ws n
浙江 金税 三期 个人所得税 扣缴 系统 官网	ns n b n v n n
北京中医药大学 培训中心	ni n
爱 老师 图片	v n n
津 国际 生物医药 联合 研究院 分析 测试 中心	j n n v n v v n
几何 手抄报 初中	n n n
公安 讲 政治 我们 怎么 讲	n v n r r v
浙江 森旺 金属制品 有限公司	ns nz n n
破解 百度 云 限速 脚本	v nz n v n
skeet	ws
新 买 的 iphone 第一次 充电	a v u v mq v
excel 试用期 转正 公式	ws n v n
广州市 高新技术 企业 奖励	ns n n v
jbl control14c t	ws ws ws
陕西省 咸阳市 彬县 公刘 中学	ns ns ns n n
pvc管 配件 大全	n n n
江河日下 的 意思	i u n
139 邮箱 登陆	m n v
梦想 改造 家 里面 可以 移动 的 餐桌	n v n nd v v u n
淫乳 浪 母	n n n
滴滴 专车 能 预约 吗	q n v v u
home uncensored kin8tengoku 1759	n n ws m
南京 住 建委 网站	ns v j n
哪 里 可以 看 金瓶梅	r nd v v n
www . yc50l . com passport	n wp ws wp ws ws
医保卡 图片	n n
夜坐 文天祥 翻译	n nh v
好听 的 辅助 名字	a u v n
浙江 固耐 橡塑 科技 有限公司	ns n j n n
杀生 因果报应 视频	v i n
苏州 就业 失业 登记证	ns v v n
新闻通讯 培训 心得体会	n v v
我 爱 发明 挖掘机 视频	r v v n n
天虹 网 上	n n nd
香河 落户 最 新 政策 2017	ns v d a n m
男人 和 女人 受精 动态图	n c n v n
韩国 梦想 演唱会	ns n n
过年 去 云南 旅游 好 吗	v v ns v a u
java 问卷调查 系统 源码	ws i n n
桑塔纳 报价	nz v
胎儿 老 打嗝	n a v
【 甲 】 臣本 布衣 【 乙 】 信 数 与 萧何	wp n wp n n wp m wp n n p nh
caxa2007 尺寸 标注 设置	ws n v v
dpph 自由基清除 实验 公式	ws n v n
5555kt . com	ws wp ws
连 的 艺术 字	v u n n
骆惠宁 视察 大同 讲话	nh v ns n
学生证 办理	n v
hypermesh 复合材料 铺 层 设计	ws ni v n v
一般 地区 的 特大 荷载 的 终端 、 耐 张 、 大 转角 、 大 跨越 等 采用 铁塔	a n u b n u n wp v q wp a n wp a v u v n
word文档 怎么 发到 邮箱	n r v n
尊 草堂 生物科技 官网	v n n n
搬家 下雨 好 吗	v v a u
350420196303070159	m
银灿 is916 量产 需要 多长 时间	nz ws j v r n
win764 开机 提示 radeon settings  host application 已经 停止 工作	ws v v ws ws  ws ws d v v
全身 锻炼 视频	n v n
google play 正在 核对	nz ws d v
胃痞 病 吃 什么 西药	n n v r n
4 * 70 + 1 铜电缆 一米 多重	m wp m wp m n mq b
金诚泰 化工 有限公司	n n n
何谓 要约 具备 什么 样 的 条件 要约 才 有效	v v v r q u n v d a
德邦 5712830837	nz m
养牛蛙 赚钱 吗	n v u
iqr 淘气 值 有 什么 用	ws a v v r p
水泥 地面 破烂 如何 修复	n n a r v
河南 银行 招聘网	ns n n
卡西欧 ms-10vc	nz ws
增城 人民医院	ns ni
深圳 前 十 女装品牌服装公司	ns nd m n
3d 全息 投影 图片	ws n v n
